00,01,02,00,03,01,04,05,00,03,01,02,03,04,05,01
03,00,01,02,06,07,08,08,07,07,07,07,07,08,05,00
01,03,03,06,08,08,08,08,08,08,09,08,08,08,10,03
02,00,01,11,08,08,08,08,08,10,03,04,08,10,00,01
12,03,02,01,11,08,08,09,10,02,01,04,05,01,02,03
01,02,00,02,01,11,10,02,01,03,02,04,05,03,01,00
00,13,14,15,02,01,02,03,02,01,03,04,05,00,03,01
02,16,17,18,03,00,03,02,03,00,01,04,05,02,01,03
01,16,17,18,00,03,00,01,01,02,00,04,08,19,00,02
00,20,17,18,03,01,00,01,00,03,02,04,08,05,03,01
03,01,20,21,02,00,02,03,01,02,01,04,08,05,02,03
01,02,01,00,01,12,03,02,00,03,02,04,08,05,00,01
12,00,03,01,02,00,03,01,03,01,00,04,08,05,02,03
03,01,02,00,03,02,01,02,00,03,03,04,08,10,03,00
01,02,00,03,01,03,13,15,01,00,03,04,05,02,01,03
02,03,01,03,00,13,17,17,15,02,01,04,05,03,00,02

0,0,0,0,0,0,1,1,0,0,0,0,0,1,1,0
0,0,0,0,1,1,0,0,1,1,1,1,1,0,1,0
0,0,0,1,0,0,0,0,0,0,1,0,0,0,1,0
0,0,0,1,0,0,0,0,0,1,0,1,0,1,0,0
0,0,0,0,1,0,0,1,1,0,0,1,1,0,0,0
0,0,0,0,0,1,1,0,0,0,0,1,1,0,0,0
0,0,0,0,0,0,0,0,0,0,0,1,1,0,0,0
0,0,0,0,0,0,0,0,0,0,0,1,1,0,0,0
0,0,0,0,0,0,0,0,0,0,0,1,0,1,0,0
0,0,0,0,0,0,0,0,0,0,0,1,0,1,0,0
0,0,0,0,0,0,0,0,0,0,0,1,0,1,0,0
0,0,0,0,0,0,0,0,0,0,0,1,0,1,0,0
0,0,0,0,0,0,0,0,0,0,0,1,0,1,0,0
0,0,0,0,0,0,0,0,0,0,0,1,0,1,0,0
0,0,0,0,0,0,0,0,0,0,0,1,1,0,0,0
0,0,0,0,0,0,0,0,0,0,0,1,1,0,0,0