1,2,3,1,4,2,5,6,1,4,2,3,4,5,6,2
4,1,2,3,7,8,9,9,8,8,8,8,8,9,6,1
2,4,4,7,9,9,9,9,9,9,10,9,9,9,11,4
3,1,2,12,9,9,9,9,9,11,4,5,9,11,1,2
13,4,3,2,12,9,9,10,11,3,2,5,6,2,3,4
2,3,1,3,2,12,11,3,2,4,3,5,6,4,2,1
1,14,15,16,3,2,3,4,3,2,4,5,6,1,4,2
3,17,18,19,4,1,4,3,4,1,2,5,6,3,2,4
2,17,18,19,1,4,1,2,2,3,1,5,9,20,1,3
1,21,18,19,4,2,1,2,1,4,3,5,9,6,4,2
4,2,21,22,3,1,3,4,2,3,2,5,9,6,3,4
2,3,2,1,2,13,4,3,1,4,3,5,9,6,1,2
13,1,4,2,3,1,4,2,4,2,1,5,9,6,3,4
4,2,3,1,4,3,2,3,1,4,4,5,9,11,4,1
2,3,1,4,2,4,14,16,2,1,4,5,6,3,2,4
3,4,2,4,1,14,18,18,16,3,2,5,6,4,1,3

0,0,0,1,1,0,0,0,0,0,1,1
0,1,1,0,0,1,1,1,1,1,0,1
1,0,0,0,0,0,0,1,0,0,0,1
1,0,0,0,0,0,1,0,1,0,1,0
0,1,0,0,1,1,0,0,1,1,0,0
0,0,1,1,0,0,0,0,1,1,0,0
0,0,0,0,0,0,0,0,1,1,0,0
0,0,0,0,0,0,0,0,1,1,0,0
0,0,0,0,0,0,0,0,1,0,1,0
0,0,0,0,0,0,0,0,1,0,1,0
0,0,0,0,0,0,0,0,1,0,1,0
0,0,0,0,0,0,0,0,1,0,1,0
0,0,0,0,0,0,0,0,1,0,1,0
0,0,0,0,0,0,0,0,1,0,1,0
0,0,0,0,0,0,0,0,1,1,0,0
0,0,0,0,0,0,0,0,1,1,0,0